2020 map -- Biden v. Trump
8,7,2,3,3,2,5,4
7,7,2,3,1,2,4,4
13,7,1,1,1,1,2,3
12,7,1,1,4,1,4,11
10,7,1,2,5,2,3,4
9,7,3,2,5,1,6,7
11,7,2,1,1,1,1,29
10,7,1,2,1,1,2,14
7,7,2,4,5,2,3,20
7,9,3,4,6,3,2,18
7,11,3,5,5,5,2,11
10,7,4,2,3,2,1,20
7,7,5,4,1,3,1,16
7,7,2,4,2,3,4,10
7,7,1,3,2,3,1,10
7,9,3,5,3,4,2,6
7,11,5,5,2,4,5,10
7,14,3,6,6,3,3,3
7,13,5,6,4,5,3,3
7,13,4,6,3,3,3,5
7,12,4,6,6,4,3,6
9,7,1,2,3,2,1,3
12,7,1,1,2,2,4,10
15,1,1,1,4,1,4,3
8,7,3,3,4,3,6,13
6,15,4,6,4,4,3,5
7,8,6,4,1,6,2,15
7,10,6,5,3,5,3,9
7,8,6,4,4,5,3,16
7,8,6,4,1,6,5,29
7,13,4,6,6,4,5,8
7,13,5,6,3,6,3,11
7,13,6,6,5,6,6,9
7,11,6,5,2,6,5,6
7,13,5,6,4,5,3,6
7,11,4,5,6,4,2,8
7,15,5,6,6,6,4,7
7,10,6,5,6,6,4,38
7,12,3,6,4,4,3,3
7,15,5,6,3,6,3,4
5,15,3,6,5,3,3,3
8,7,3,3,6,5,4,9
8,7,4,3,5,6,5,5
7,8,5,4,4,6,5,11
7,14,4,5,6,6,4,6
7,7,5,3,6,6,3,6
10,7,3,2,2,3,3,12
9,7,2,2,3,4,1,7
12,7,2,1,1,3,3,55
7,11,1,5,3,2,6,3
14,7,2,1,2,2,6,4
