2004 map -- Kerry v. Bush
9,7,2,3,3,2,5,4
7,7,2,3,1,2,4,4
9,7,1,1,1,1,2,3
13,7,1,1,4,1,4,12
13,7,1,2,5,2,3,4
10,7,3,2,5,1,6,7
12,7,2,1,1,1,1,31
10,7,1,2,1,1,2,15
8,7,2,4,5,2,3,21
7,7,3,4,6,3,2,20
7,10,3,5,5,5,2,11
9,7,4,2,3,2,1,21
8,7,5,4,1,3,1,17
7,7,2,4,2,3,4,10
8,7,1,3,2,3,1,10
7,7,3,5,3,4,2,7
7,8,5,5,2,4,5,11
7,12,3,6,6,3,3,3
7,11,5,6,4,5,3,3
7,13,4,6,3,3,3,5
7,12,4,6,6,4,3,6
9,7,1,2,3,2,1,3
10,7,1,1,2,2,4,10
15,1,1,1,4,1,4,3
7,9,3,3,4,3,6,13
7,8,4,6,4,4,3,5
7,10,6,4,1,6,2,15
7,10,6,5,3,5,3,8
7,9,6,4,4,5,3,15
7,7,6,4,1,6,5,27
7,10,4,6,6,4,5,8
7,8,5,6,3,6,3,11
7,10,6,6,5,6,6,9
7,10,6,5,2,6,5,6
7,8,5,6,4,5,3,6
7,8,4,5,6,4,2,9
7,11,5,6,6,6,4,7
7,11,6,5,6,6,4,34
7,12,3,6,4,4,3,3
7,15,5,6,3,6,3,4
7,15,3,6,5,3,3,3
7,9,3,3,6,5,4,9
7,7,4,3,5,6,5,5
7,8,5,4,4,6,5,10
7,15,4,5,6,6,4,5
7,8,5,3,6,6,3,5
8,7,3,2,2,3,3,11
7,7,2,2,3,4,1,7
9,7,2,1,1,3,3,55
7,14,1,5,3,2,6,3
11,7,2,1,2,2,6,4
